#########################
#   #      #  D         #
# S #      #            #         
##  #      ###3###  ## ##          
#                       #         
#           D           #########
#                               3  
#      ##3##  #####     #########        
##########       #3     #
3   D             #     #
###################     #
#      D                #
#                       #
#########################   			   
