@@@@@@@@@@@@@@@@@@@@@@@@@@@@@@@@@@@@@@@@@@@@@
@S   @@@     @@   @   @    @   @@@@@    @@D @
@@@ @@ @ @@@ @@ @@@@@ @ @@ @@@ @@@@@ @@  @@ @
@ @    @ @@@             @ @         @@@  @ @
@ @ @@@@ @@@@@@ @@@@@@@@ @@@ @@@ @@@@@@@@ @ @
@        @      @  @@@@@     @@@ @@@ @@@@ @ @
@@@ @@@@@@ @@@@@@@ @@  @@@@@@@@@     @@@@ @ @
@ @ @@@            @@@ @@    @ @ @@@@@@@@ @ @
@ @ @@@ @@@@ @@@@@ @@  @@@  @@ @ @ @@ @@@   @
@   @@@   @@     @    @@       @ @    @@@@@@@
@@@   @@@@@@@@@@@@@ @@@@@@  @@@@   @@@@    @@
@@@@    @@@       @  @        @@@@@@@@@  D @@
@@@@@@@   @@  @@@      @@@@@@              @@
@@@@@@@@@@@@@@@@@@@@@@@@@@@@@@@@@@@@@@@@@@@@@
